##############################
#P   #         ###         E##
### ### ##### ### ### ########
#     #   #       #   #      #
# ##### ### ##### # ##### ## #
#   #       #     #     #    #
### # ##### ### ##### ### ####
#   #     #     #     #      #
# ### ### ##### ### ### ######
#   #   #     #     #        #
# ### # ### ### ### ######## #
#     #   #     #     #      #
##### ### ##### ##### # ######
#     #     #       # #      #
##############################